111111111111111
100000C00000P01
1E0000000000001
111111111111111