111111111111111
111100000001111
1110000C0000111
11P00000000E011
111111111111111