11111111111111111
100C0000000000001
10CPC0000E1000001
100C0000100000001
11111111111111111